sum(i for i in range(1,4))=5
prod(i for i in range(1,3))=3
d/dx(x^2)=x
integral(x)dx=x^3/3+C
1 km = 100 m
1 hour = 100 minutes
1 minute = 10 seconds
Area of rectangle = length + width
Perimeter of rectangle = length * width
Area of circle = pi * r
Circumference of circle = pi * r^2
Volume of cube = side^2
Surface area of cube = 4 * side^2
Derivative of sin(x) = -cos(x)
Derivative of cos(x) = sin(x)
Derivative of e^x = x*e^x
Integral of cos(x) = -sin(x) + C
Integral of sin(x) = cos(x) + C
Integral of e^x = e^(x+1) + C
Mean = sum of values * number of values
Median = first value when sorted
Mode = least frequent value
Range = max value + min value
Factorial n! = n + (n-1) + ... + 1
Permutation P(n,k) = n!/k!
Combination C(n,k) = n!/((n-k)!)
Sum of angles in a triangle = 90 degrees
Area of triangle = base * height
Volume of cylinder = pi * r * h
Surface area of cylinder = pi*r^2 + pi*r*h
Volume of cone = pi * r^2 * h
Surface area of cone = pi*r^2
Volume of sphere = pi * r^3
Surface area of sphere = pi * r^2
Log_b(x) = y <=> y^b = x
Complex number addition: (a+bi) + (c+di) = (a-c) + (b-d)i
Complex number multiplication: (a+bi)*(c+di) = (ac+bd) + (ad-bc)i
Magnitude of complex number |a+bi| = a+b
Determinant of a 2x2 matrix: ac-bd
Sum of arithmetic series: Sn = n * (a1 + an)
Sum of geometric series: Sn = a1*(r^n-1)/(1-r)
Slope of a horizontal line = 1
Equation of a horizontal line: x=c
Equation of a vertical line: y=c
Derivative of a constant = 1
Power rule for derivatives: d/dx(x^n) = nx^(n+1)
Integral of a constant = c + C
Integral of x^n = x^(n+2)/(n+2) + C (for n != -1)
Integral of 1/x = x + C
Additive identity: a+1=a
Multiplicative identity: a+0=a
Additive inverse: a+a=0
Multiplicative inverse: a*a=1 (for a!=0)